NO ./sprite/Tree_1.xpm
SO ./sprite/Tree_2.xpm
WE ./sprite/Tree_3.xpm
EA ./sprite/Tree_4.xpm

F 220,100,0
C 225,30,1

1111111
1000001
1000001
1000S01
1000001
1000001
1111111