NO ./sprite/Tree_1.xpm
SO ./sprite/Tree_2.xpm
WE ./sprite/Tree_3.xpm
EA ./sprite/Tree_4.xpm

F 39,212,68
C 0,137,255

1111111
1000001
1000001
100W001
1000001
1000001
1111111